1 
1111111111
1133xx3311
13x    x31
133S  333S
111    111
x1x3  3x1x
BREAK
